                      ####            
                 ######  #            
+-----+          #       ##           
|.....|          #                    
|.....######  +--#----+               
|.....|    #  |.......|  ##           
+--#--+    #  |.......|   #######     
   #       ####.......|     #         
   #          |.......|     #         
####          |.......|     ####      
#     ###     +---#---+        #      
##      #         #            #      
        #         #     +------#----+ 
     +--#--+      ####  |...........| 
  #  |.....|         #  |...........| 
  #  |.....|         ####...........| 
  ####.....####         |...........| 
  #  |.....|  #         |...........| 
  #  +-----+  #         |...........| 
 ##           ###########...........| 
      #########         +-----------+ 
    ###       #                       
      #       # +----------+   ####   
     +#+      # |..........#####  #   
     |.|      ###..........|      ##  
     |.|        |..........|          
     |.|        +-------#--+   #      
     |.|                #      #####  
     +-+                ########   #  